ABC D -> MAU P
ABE FGHIJK -> MAX STYLER
AJALB -> MEMBA
AMNOBJI FDBKPF -> MICHAEL SPARKS
AMFF QKJ -> MISS DRE
RJKS (QT FJG) -> NERO (DJ SET)
RUOGAKJ -> NGHTMRE
RMNSIJ ASCQBLJK -> NICOLE MOUDABER
RSMVC LWL TSFOXB -> NOIZU B2B JOSHWA
SIMYJK OJIQJRF -> OLIVER HELDENS
SFMKMF -> OSIRIS
DBGKMNP GSDDMRU -> PATRICK TOPPING
FGS -> STO
DSKGJK KSLMRFSR (QT FJG) -> PORTER ROBINSON (DJ SET)
KMSG GJR -> RIOT TEN
FBLBM -> SABAI
KBH YSIDJ LWL NKBRPQBG -> RAY VOLPE B2B CRANKDAT
FJYJR IMSRF GM -> SEVEN LIONS TI
GSRU -> TONG
MRSR -> INON
FICFOMM -> SLUSHII
FSZM GCPPJK (QT FJG) -> SOFI TUKKER (DJ SET)
FCDJK ZCGCKJ -> SUPER FUTURE
FYQQJR QJBGO -> SVDDEN DEATH
FHJRNJ -> SYENCE
FHRHABGB -> SYNYMATA
GJIHPBFG GKMYJNGB -> TELYKAST TRIVECTA
YBIJRGMRS POBR -> VALENTINO KHAN
HJGJD -> YETEP
YBIJRGMRS POBR -> VALENTINO KHAN
YBADBHQU -> VAMPAYDG
VJPJ LJBGF -> ZEKE BEATS
VMRUBKBGSXRFOMD -> ZINGARATOWNSHIP
KJLJIIMSR -> REBELLION
GKMYJNGB -> TRIVECTA
ASQBDMG -> MODAPIT
ASPFM -> MOKSI
ASKGJR -> MORTEN

W -> 2
B -> A
L -> B
N -> C
Q -> D
J -> E
Z -> F
U -> G
O -> H
M -> I
T -> J
P -> K
I -> L
A -> M
R -> N
S -> O
D -> P
K -> R
F -> S
G -> T
C -> U
Y -> V
X -> W
E -> X
H -> Y
V -> Z
